n1 = new N(5);

0x804a008:	0x00000000	0x00000000	0x00000000	0x00000000
0x804a018:	0x00000000	0x00000000	0x00000000	0x00000000
0x804a028:	0x00000000	0x00000000	0x00000000	0x00000000
0x804a038:	0x00000000	0x00000000	0x00000000	0x00000000
0x804a048:	0x00000000	0x00000000	0x00000000	0x00000000
0x804a058:	0x00000000	0x00000000	0x00000000	0x00000000
0x804a068:	0x00000000	0x00000000	0x00000000	0x00020f91
0x804a078:	0x00000000	0x00000000	0x00000000	0x00000000
0x804a088:	0x00000000	0x00000000	0x00000000	0x00000000
0x804a098:	0x00000000	0x00000000	0x00000000	0x00000000
0x804a0a8:	0x00000000	0x00000000	0x00000000	0x00000000
0x804a0b8:	0x00000000	0x00000000	0x00000000	0x00000000
0x804a0c8:	0x00000000	0x00000000	0x00000000	0x00000000
0x804a0d8:	0x00000000	0x00000000	0x00000000	0x00000000
0x804a0e8:	0x00000000	0x00000000	0x00000000	0x00000000
0x804a0f8:	0x00000000	0x00000000	0x00000000	0x00000000


0x804a008:	0x08048848	0x00000000	0x00000000	0x00000000
0x804a018:	0x00000000	0x00000000	0x00000000	0x00000000
0x804a028:	0x00000000	0x00000000	0x00000000	0x00000000
0x804a038:	0x00000000	0x00000000	0x00000000	0x00000000
0x804a048:	0x00000000	0x00000000	0x00000000	0x00000000
0x804a058:	0x00000000	0x00000000	0x00000000	0x00000000
0x804a068:	0x00000000	0x00000000	0x00000005	0x00020f91
0x804a078:	0x00000000	0x00000000	0x00000000	0x00000000
0x804a088:	0x00000000	0x00000000	0x00000000	0x00000000
0x804a098:	0x00000000	0x00000000	0x00000000	0x00000000
0x804a0a8:	0x00000000	0x00000000	0x00000000	0x00000000
0x804a0b8:	0x00000000	0x00000000	0x00000000	0x00000000
0x804a0c8:	0x00000000	0x00000000	0x00000000	0x00000000
0x804a0d8:	0x00000000	0x00000000	0x00000000	0x00000000
0x804a0e8:	0x00000000	0x00000000	0x00000000	0x00000000
0x804a0f8:	0x00000000	0x00000000	0x00000000	0x00000000


n2 = new N(6);
0x804a008:	0x08048848	0x00000000	0x00000000	0x00000000
0x804a018:	0x00000000	0x00000000	0x00000000	0x00000000
0x804a028:	0x00000000	0x00000000	0x00000000	0x00000000
0x804a038:	0x00000000	0x00000000	0x00000000	0x00000000
0x804a048:	0x00000000	0x00000000	0x00000000	0x00000000
0x804a058:	0x00000000	0x00000000	0x00000000	0x00000000
0x804a068:	0x00000000	0x00000000	0x00000005	0x00000071
0x804a078:	0x00000000	0x00000000	0x00000000	0x00000000
0x804a088:	0x00000000	0x00000000	0x00000000	0x00000000
0x804a098:	0x00000000	0x00000000	0x00000000	0x00000000
0x804a0a8:	0x00000000	0x00000000	0x00000000	0x00000000
0x804a0b8:	0x00000000	0x00000000	0x00000000	0x00000000
0x804a0c8:	0x00000000	0x00000000	0x00000000	0x00000000
0x804a0d8:	0x00000000	0x00000000	0x00000000	0x00020f21
0x804a0e8:	0x00000000	0x00000000	0x00000000	0x00000000
0x804a0f8:	0x00000000	0x00000000	0x00000000	0x00000000


0x804a008:	0x08048848	0x00000000	0x00000000	0x00000000
0x804a018:	0x00000000	0x00000000	0x00000000	0x00000000
0x804a028:	0x00000000	0x00000000	0x00000000	0x00000000
0x804a038:	0x00000000	0x00000000	0x00000000	0x00000000
0x804a048:	0x00000000	0x00000000	0x00000000	0x00000000
0x804a058:	0x00000000	0x00000000	0x00000000	0x00000000
0x804a068:	0x00000000	0x00000000	0x00000005	0x00000071
0x804a078:	0x08048848	0x00000000	0x00000000	0x00000000
0x804a088:	0x00000000	0x00000000	0x00000000	0x00000000
0x804a098:	0x00000000	0x00000000	0x00000000	0x00000000
0x804a0a8:	0x00000000	0x00000000	0x00000000	0x00000000
0x804a0b8:	0x00000000	0x00000000	0x00000000	0x00000000
0x804a0c8:	0x00000000	0x00000000	0x00000000	0x00000000
0x804a0d8:	0x00000000	0x00000000	0x00000006	0x00020f21
0x804a0e8:	0x00000000	0x00000000	0x00000000	0x00000000
0x804a0f8:	0x00000000	0x00000000	0x00000000	0x00000000
